########################################################################################################################################################################################################|
########################################################################################################################################################################################################|
########################################################################################################################################################################################################|
###..................................................................................................................................................................................................###|
###..................................................................................................................................................................................................###|
###..................................................................................................................................................................................................###|
###..................................................................................................................................................................................................###|
###..................................................................................................................................................................................................###|
###..................................................................................................................................................................................................###|
###..................................................................................................................................................................................................###|
###..................................................................................................................................................................................................###|
###..................................................................................................................................................................................................###|
###..................................................................................................................................................................................................###|
###..................................................................................................................................................................................................###|
###..................................................................................................................................................................................................###|
###..................................................................................................................................................................................................###|
###..................................................................................................................................................................................................###|
###..................................................................................................................................................................................................###|
###..................................................................................................................................................................................................###|
###..................................................................................................................................................................................................###|
###..................................................................................................................................................................................................###|
###..................................................................................................................................................................................................###|
###..................................................................................................................................................................................................###|
###..................................................................................................................................................................................................###|
###..................................................................................................................................................................................................###|
###..................................................................................................................................................................................................###|
###..................................................................................................................................................................................................###|
###..................................................................................................................................................................................................###|
###..................................................................................................................................................................................................###|
###..................................................................................................................................................................................................###|
###..................................................................................................................................................................................................###|
###..................................................................................................................................................................................................###|
###..................................................................................................................................................................................................###|
###..................................................................................................................................................................................................###|
###..................................................................................................................................................................................................###|
###..................................................................................................................................................................................................###|
###..................................................................................................................................................................................................###|
###..................................................................................................................................................................................................###|
###..................................................................................................................................................................................................###|
###..................................................................................................................................................................................................###|
###..................................................................................................................................................................................................###|
###..................................................................................................................................................................................................###|
###..................................................................................................................................................................................................###|
###..................................................................................................................................................................................................###|
###..................................................................................................................................................................................................###|
###..................................................................................................................................................................................................###|
###..................................................................................................................................................................................................###|
########################################################################################################################################################################################################|
########################################################################################################################################################################################################|
########################################################################################################################################################################################################!



