##############################################################################################################################################################################################|
##############################################################################################################################################################################################|
###........................................................................................................................................................................................###|
###........................................................................................................................................................................................###|
###........................................................................................................................................................................................###|
###........................................................................................................................................................................................###|
###........................................................................................................................................................................................###|
###........................................................................................................................................................................................###|
###........................................................................................................................................................................................###|
###........................................................................................................................................................................................###|
###........................................................................................................................................................................................###|
###........................................................................................................................................................................................###|
###........................................................................................................................................................................................###|
###........................................................................................................................................................................................###|
###........................................................................................................................................................................................###|
###........................................................................................................................................................................................###|
###........................................................................................................................................................................................###|
###........................................................................................................................................................................................###|
###........................................................................................................................................................................................###|
###........................................................................................................................................................................................###|
###........................................................................................................................................................................................###|
###........................................................................................................................................................................................###|
###........................................................................................................................................................................................###|
###........................................................................................................................................................................................###|
###........................................................................................................................................................................................###|
###........................................................................................................................................................................................###|
###........................................................................................................................................................................................###|
###........................................................................................................................................................................................###|
###........................................................................................................................................................................................###|
###........................................................................................................................................................................................###|
###........................................................................................................................................................................................###|
###........................................................................................................................................................................................###|
###........................................................................................................................................................................................###|
###........................................................................................................................................................................................###|
###........................................................................................................................................................................................###|
###........................................................................................................................................................................................###|
###........................................................................................................................................................................................###|
###........................................................................................................................................................................................###|
###........................................................................................................................................................................................###|
###........................................................................................................................................................................................###|
###........................................................................................................................................................................................###|
###........................................................................................................................................................................................###|
###........................................................................................................................................................................................###|
###........................................................................................................................................................................................###|
###........................................................................................................................................................................................###|
###........................................................................................................................................................................................###|
###........................................................................................................................................................................................###|
###........................................................................................................................................................................................###|
##############################################################################################################################################################################################|
##############################################################################################################################################################################################!


